###############
#      @      #
#    b   b    #
# #         ###
# #    b    # #
# #    b    # #
# #    b    # #
# #    b    # #
#a#    b    # #
###h#  b    # #
#2aa#         #
#aa#       b  #
######   ######
#      x    o*#
###############
